none=无
victory=胜利
defeat=战败
casualties=双方战损
attacker=攻击方
defender=防守方
pause=等待
defend=防御
magic=施法
stat_att=攻击力
stat_def=防御力
stat_damage=杀伤力
stat_ammo=弹药量
stat_hp=剩余生命值
stat_hpMax=最大生命值
stat_speed=速度
Undead=亡灵
Amazon=战争仕女
DH=猎魔人
DH_Upgrade=维拉
Tyrael=正义天使
Jaina=吉安娜
Sylvanas=希尔瓦娜斯
Kerrigan=刀锋女王
Kerrigan_Upgrade=凯瑞甘
battleResult_victory=辉煌的胜利！\n因为英勇作战,{0}获得了{1}经验值
battleResult_defeat=你的军队惨遭失败，{0}背叛了你
battleInfo_attack=攻击{0}（伤害{1}）
battleInfo_attack_range=攻击{0}（伤害{1}-{2}）
battleInfo_shoot=射击{0}（还剩{1}发，伤害{2}）
battleInfo_shoot_range=射击{0}（还剩{1}发，伤害{2}-{3})
battleInfo_damage={0}造成{1}点伤害
battleInfo_death=，{0}个{1}死了
battleInfo_pause={0}暂停，等待更佳的机会行动
battleInfo_defend={0}选择防御，获得+{1}防御力
battleInfo_roundStart=下一回合开始
battleInfo_lifeDrain={0}从{1}吸收了{2}点生命
battleInfo_lifeDrain_resurrection=，并有{0}个复活了
battleInfo_regeneration={0}的伤口愈合了，并恢复所有生命值
Crusader_Upgrade=乔汉娜
Kel_Upgrade=克尔苏加德
Leoric_Upgrade=李奥瑞克
Malthael_Upgrade=玛瑟伊尔
Malthael=死亡天使
Medivh_Upgrade=麦迪文
Stitches=缝合怪
Flying=飞行
Double attack=攻击两次
Immune to jousting=免疫冲锋
No melee penalty=近战伤害不减
Life drain=吸血
Teleporting=瞬移
Regeneration=再生
Mana drain=法力吸取
Disease=雷鸣爆弹
Castle=城镇
No enemy retaliation=不受反击
Two retaliations=反击两次
Unlimited retaliations=无限反击
Arthas=死亡骑士
Curse=诅咒
MagicMissiles=魔法飞弹
Magic Missiles=魔法飞弹
Bestow Hope=希望恩赐
Magic_Level={0}级
Magic_Mana=魔法值: {0}
Oil=浮油
Armor Of The Archlich=大巫妖护甲
Rain Of Fire=毁灭之雨
Crossfade Speed=加速音效
Blinding Light=致盲之光
Deploy Shield=护卫
Blink=闪现
Ring Of Frost=冰霜之环
Devouring Maw=吞噬巨口
Frost Bolt=寒冰箭
Shield Of Hope=希望之盾
Healing Brew=治愈佳酿
Apocalypse=天启
Summon Water Elemental=召唤水元素
Bloodlust=嗜血术
Pyroblast=炎爆术
Lightning Surge=闪电喷涌
Shrink Ray=缩小射线
Force Wall=力场屏障
Chain Lightning=闪电链
Hunters Mark=猎人印记
Portal=传送门
Ultimate Evolution=终极进化
Army Of The Dead=亡者大军
Resurrect=圣洁新生
Time Warp=减速沙尘
Toxic Nest=剧毒巢穴
Earthquake=地震术
Cancel=取消
Mana=法力值
Frost Bolt_Info=从选中的敌方部队身上吸走热量
